{
  "keymapShowTopRow": true,
  "type": "ansi",
  "keys": {
    "row1": [
      ["`", "~"],
      ["1", "!"],
      ["2", "@"],
      ["3", "#"],
      ["4", "$"],
      ["5", "%"],
      ["6", "^"],
      ["7", "&"],
      ["8", "*"],
      ["9", "("],
      ["0", ")"],
      ["[", "{"],
      ["]", "}"]
    ],
    "row2": [
      ["z", "Z"],
      ["y", "Y"],
      ["o", "O"],
      ["u", "U"],
      [";", ":"],
      ["q", "Q"],
      ["l", "L"],
      ["d", "D"],
      ["p", "P"],
      ["x", "X"],
      ["", ""],
      ["", ""],
      ["", ""]
    ],
    "row3": [
      ["w", "W"],
      ["c", "C"],
      ["i", "I"],
      ["e", "E"],
      ["a", "A"],
      [",", "<"],
      ["k", "K"],
      ["h", "H"],
      ["t", "T"],
      ["n", "N"],
      ["s", "S"],
      ["f", "F"]
    ],
    "row4": [
      ["'", "\""],
      ["-", "_"],
      ["=", "+"],
      [".", ">"],
      ["/", "?"],
      ["j", "J"],
      ["m", "M"],
      ["g", "G"],
      ["b", "B"],
      ["v", "V"]
    ],
    "row5": [
      [" "],
      ["R"]
    ],
  }
}
